* * * * * * * * * * * * * * * * * *
* - - - - - - - - - - - - - - - - *
* 1 X - O - O - O - X - O - O - X *
* - X - - - - - - - - - - - - - X *
* - - - - O - O - - - - O - O - - *
* - - - - O - O - - - - O - O - - *
* X - - - - - - - - - - - - - - X *
* X - O - O - X - O - O - X - O 2 *
* - - - - - - - - - - - - - - - - *
* * * * * * * * * * * * * * * * * *