* * * * * * * * * * * * * * * * * * * * *
* - - X - - X O - X - - - - O - X O - X *
* 1 O X O - O - O - O - O - - O - - O - *
* - X X X O - X X - - X O - X X - X X - *
* X O - O X O - O X O - O O - O X - O X *
* - - - - - - X - - O X - - X - - X - - *
* - O X O X O X O - O X O - X O - X O 2 *
* - - X - - X - X - X - - - - X - - X - *
* * * * * * * * * * * * * * * * * * * * *