< * * * * * * * * * * * * * * * >
* - - - X - - - - - X - O - O - *
* - O - X - O - O - X - - - X - *
* - X < T > - X X - - < T > 2 O *
* - O L - R - - - - - L - R - X *
* - - v B ^ - - - - - v B ^ - - *
* O - X O X - - - - - X O - O X *
* O - - - - - - - - - - - - O X *
* - - < T > X - X - X < T > - - *
* - X L - R - X - X - L - R O - *
* X 1 v B ^ - - X - - v B ^ O - *
* - - X O O - O - X - O - - O - *
* - X - - X O - O - O X X - - - *
v * * * * * * * * * * * * * * * ^
