* * * * * * * * * * * * * * * * *
* - - - X - - - - - X - O - O - *
* - O O X 1 - - O - X - - - X - *
* - O O X - - - X - - - O X O O *
* - - - O X O - O X - - - - O X *
* - X - - - - X - - O X - - - - *
* O - O - O - - O - - - O - O X *
* - - O - O - - O - X - O - O - *
* - O - O - - - X - O - X - X - *
* X - - - - X - X - - - 2 O O - *
* X - X O - O - O - O X - O O - *
* - X - - O X - - - - - X - - - *
* * * * * * * * * * * * * * * * *
