* * * * * * * * * * * * * * * * *
* - - - X - - - - - X - - - - - *
* - O O O 1 - - O - X - O O O - *
* - O O O - - - X - - - O O O - *
* - O O O X O - O X - - O O O - *
* - X - - - - X - - O X - - - - *
* - - O - O - - O - O - O - O X *
* - - O - O - - O - O - O - O - *
* - - - O - - - X - O - - - - - *
* X O O - - X - X - - - 2 O O - *
* X O O - - O - O - O X - O O - *
* - X - - O X - - - - - X - - - *
* * * * * * * * * * * * * * * * *
