* * * * * * * * * * * * * * * * *
* - - - X - - - - - X - - - - - *
* 1 < T > - X - X - X - < T > - *
* - L - R - - - X - - - L - R - *
* - v B ^ X O - O X - - v B ^ - *
* - X - - - - X - - O X - - - - *
* O - O - O - O - O - O - O - O *
* O - O - O - O - O - O - O - O *
* - - - X X - - X - - - - X - - *
* X < T > - X - X - - - < T > - *
* X L - R - O - O - O X L - R - *
* - v B ^ X X - - X - - v B ^ 2 *
* - - - - X - - X - - - - - - - *
* * * * * * * * * * * * * * * * *
