* * * * * * * * * * * * * * * * *
* - - - X - - - - - X - - - - - *
* 1 O O O - - - O - X - O O O - *
* - O O O - - - X - - - O O O - *
* - O O O X O - O X - - O O O - *
* - X - - - - X - - O X - - - - *
* - - O - O - - O - O - O - O X *
* - - O - O - - O - O - O - O - *
* - - - O X - - X - - - - - - - *
* X O O O - X - X - - - O O O - *
* X O O O - O - O - O X O O O - *
* - O O O X X - - X - - O O O 2 *
* - - - - X - - - - - - - - - - *
* * * * * * * * * * * * * * * * *
