O - - O - O - O - O - O
O 1 - - X - - - - - - O
O - - - - - - - - - - O
O - - - - - - - - - - O
O - - - - - X - - - - O
O - - - X - X X X - - O
O - - - - - - - - - - O
O - - - - - X X X - - O
O - - - - - - - - - - O
O - - - - - - - - O 2 0
O - - O - O - O - O - O